3 13 31
###############################
#p  m** **2   *   2      2    #
# # # #*# # # # # # # # # # # #
#*    ** * *  *    * ** 3 *   #
# # # # # #*# # # # # # #*# # #
#*   *s*    *** *   **        #
# # # # # # # # # # # # # #*# #
#    *     * 3      *    **  3#
# #*# # #*#*#*#*# # #1# # #*# #
#        *   *4*  x *   *     #
#*# # # # # # # # # # #*# # #*#
# *    * **1   ** ***     1   #
###############################