8 13 31
###############################
#p   b ** *    *   *  * * *   #
# *************************** #
#   *m ***1  *   1  *   * *   #
# *************************** #
#f   5 *  5  #   3  5  5#  2  #
# *************************** #
#*  *  * 5 *  * 1    * 1      #
# *************************** #
#***2 **  * 5  x  *  5 4      #
# *************************** #
#w  **  1 * *   *  *    2  3  #
###############################