2 13 31
###############################
#p m  * **    *   3   2       #
# # # #*# # # # # # # # # # # #
#  x   ** * *  *   * ** 3 *   #
# # # # # #*# # # # # # #*# # #
#*   * *    *b* *   **        #
# # # # # # # # # # # # # #*# #
#1   *     *        *    **  2#
# #*# # #*#*#*#*# # #1# # #*# #
#        * 2 *2*    *   *     #
#*# # # # # # # # # # #*# # #*#
# *    * **    ** ***     1   #
###############################