7 13 31
###############################
#p   b ** *  4 *   *  * * *   #
# # # #*# # #*#*# # # #*#*#*# #
#   * 1   ***  *4  1  * 5 * * #
# # # # # #*# # #*#*# # # # #*#
#f      2    ** *  *   x      #
# # # # # # # # # #*# #*# # # #
#*  *      *  * 3    * 3 5    #
# # # # #*# # # #*#*# # # # # #
#*    **  * 2     * 5         #
# #*# # # # # # #*# # # # # # #
#w     * 1   *  3* *    2     #
###############################