6 13 31
###############################
#p *  * *  3  s   1  * b 1  * #
# # # # #*# # #*# # # # # #*# #
#    * * *** **  5   *    **  #
# #*# # # # #4# #b#1# # # # #*#
#m         *     **      *  **#
# # #*# # # # # #*#*#*#*# # # #
#   *      f *   * * * *   4  #
# # # # #*# # # # # # #*# #*# #
#   3    x *   *5 2           #
# # # # # # # # # #*# # # # #*#
#w ** *5  *    2              #
###############################