4 13 31
###############################
#p   * **  x *   3   4        #
# #*# #*# # # # # # # # # # # #
#      **4* *  *   * ** 3 *   #
# # # # # #*# # # # # # #*# # #
#*   * *    *b* *   **        #
# # # # # # # # # # # # # #*# #
#    * s   * 1      *    **  3#
# #*# #*#*#*#*#*# # #1# # #*# #
#   *    * 4 *2     *   *     #
#*# # # # # # # # # # #*# # #*#
# *    * **    ** ***     1   #
###############################