1 13 31
###############################
#p   b *  *    *   *  * * *   #
# *  #*#    *#*#*   #*#*#*1   #
#   * *** * * * *  * f * #*  *#
#  #*1 * #*# 1 * #  # *     * #
#f   *  * *  *x *  *     # *  #
#  # 1 * # #    *#  # # #**   #
#*      *  * **       * 1 1   #
#w * #*#  * 1#*#* 1 # 1 * * * #
#* *  **  *       *           #
# *   *          * ** *  * 2 *#
# * *#  1 # * # *  # #  # #  ##
###############################