5 13 31
###############################
#p * *3       *  ** * *      *#
# # # # #*# # #*# # # # # #*# #
#    * * *** **  5   *    **  #
# #*# # # # #4# #b#1# # # # #*#
#m       x *     **      *  **#
# # #*# # # # # #*#*#*#*# # # #
#   *        *   * * * *   4  #
# # # # #*# # # # # # #*# #*# #
#   ****         *2           #
# # # # # # # # # #*# # # # #*#
#w ** *5  *    2              #
###############################